1111111111111
1CEP00000001
1111111111111
