111111111111111111111111111111111111111111111
100000000000000000000001000000000000011110111
100000000000000000000001000000000000011111011
1000000000000CCCC0000001000000000000011111101
10000000M000000000000001000000000000001111111
100000000000000000000001000000000000010111111
100000000000000000000001000000000000011011111
10000000M000000000000001000000000000011101111
100000000000000000000011000000000000000110111
111100000000000000000010000000000011000011011
111110000000000000000110000000000001100000111
1111110000MM000000000100000000000000010000111
1111111000MM000000001100000000000000001000011
111111110000000000011000000000000000M00100011
111111110000000000010000000000000000000101101
101100000000000000011000000000000000000010011
100100011000000000000110000CC0000000000010011
1001001011000000000000110000CC000000000010001
1000100000100000000000001100CC000000000010001
111000000001100000000000011000000000000010011
1100C0000000010000000000000000000000000100111
110000000000001000000000010000001110010000111
100000000000001000001100011000010001100000111
1100000000000001101100000011000101000000M0111
111100000000000000000000000100010011100000111
11100000M00000000000000000010000101E110001111
111000000000000000000000011100001000111110001
100001110000000000000000010000001111100000001
10001111110000000P000000100000000000000000001
111111111111111111111111111111111111111111111
