11111111111111111111111111111111111111111111
10000000000000000000000100000000000001111111
100000000000P0000000001100000000000000011111
11110000000000000000001000000000001100001111
11111000000000000000011000000000000110000111
11111100000000000000010000000000000001000111
11111110000000000000110000000000000000100011
11111111000000000001100000000000000000010011
11111111000000000001000000000000000000010111
10110000000000000001100000000000000000010011
10010001100000000000011000000000000000010011
10010010110000000000001100000000000000010001
10001000001000000000000011000000000000010001
11100000000110000000000001100000000000010011
1100C000000001000000000000000000000000100111
11000000000000100000000001000000111001000111
10000000000000100000110001100001000110000111
11000000000000011111000000110001010000000111
11110000000000000000000000010001001110000111
11100000000000000000000000010000101E11001111
11100000000000000000000001110000100011111001
10000111000000000000000001000000111110000001
10001111110000000000000010000000000000000001
11111111111111111111111111111111111111111111
