111111111111111111111111111111111111111111111
100000000000000000000001000000000000011110111
100000000000000000000001000000000000011111011
100000000000000000000001000000000000011111101
100000000000000000000001000000000000001111111
100000000000000000000001000000000000010111111
100000000000000000000001000000000000011011111
100000000000000000000001000000000000011101111
100000000000000000000011000000000000000110111
111100000000000000000010000000000011000011011
111110000000000000000110000000000001100000111
111111000000000000000100000000000000010000111
111111100000000000001100000000000000001000011
111111110000000000011000000000000000000100011
111111110000000000010000000000000000000101101
101100000000000000011000000000000000000010011
100100011000000000000110000000000000000010011
100100101100000000000011000000000000000010001
100010000010000000000000110000000000000010001
111000000001100000000000011000000000000010011
1100C0000000010000000000000000000000000100111
110000000000001000000000010000001110010000111
100000000000001000001100011000010001100000111
110000000000000110110000001100010100000000111
111100000000000000000000000100010011100000111
11100000000000000000000000010000101E110001111
111000000000000000000000011100001000111110001
100001110000000000000000010000001111100000001
10001111110000000P000000100000000000000000001
111111111111111111111111111111111111111111111
