111111111111111111111111111111111111
111110000001011110000000000000000001
11P0001000000001000M0000011111000001
111111000000000000000111100001100001
111C00011111001111111011001100110001
10C111100000110000100000010000010001
10001110000000000000000000010C100001
100011000000110000000000000011100001
100001000000110000000000100001000001
100010000001110000000000100001000001
100110000011000000000001100000110001
100010000011110000000111110000001001
100110000111100000001111100000000101
100000000110110000011101100000000101
100000001110011000110000110000000101
100000011100000000000000111000000101
100M00110000000000000000011000011001
1000001100000000M0000000001010010011
1000001100000M00000M0000000110010011
100000011000000000000000001100110001
100000011000000000000000011000100001
1000000011100000000000001000M0010001
110000000110000000000001100001110001
110000000111100001001111101011000001
111000000011110001111111111011000001
110111000011000000000111110011000001
111100000111000000000011110010000001
100000001101100000000001110110000001
100M00011100010000000000100100000001
100000010001000100000000010C10000001
110000110001001C10000000001100000001
1100000100M0111011111000000000000001
100000011000000011000111110000000111
1100000011110011100M0000001100011111
111000000000111100000010000010110E11
11111100000000000001011110001110M001
11111111000000000011000C110000000011
111111111111111111111111111111111111
