1111111111111111111
1111111111111111001
1111111C1E111P11011
1111111111111111111
