1111111111
11P011C001
1100111101
1001100001
1100001101
1M00011111
1111001E11
1000000011
1111111111
