1111111111
1100110101
11C0011111
1001010001
110P001101
1000011111
1110000011
10000E0011
1111111111
