1111111111
1000000001
10C0000001
1000000001
100P000001
1000000001
1000000001
10000E0001
1111111111
