11111111111
11111000001
1C1100001P1
10011001M11
10001000101
10100000011
11M10000111
1E1000001C1
10000110001
11111111111
