1111111111
1P000000C1
1000000001
1000000001
1000000001
10000M0001
1000000001
1000000001
1C000000E1
1111111111
