11111111111111111111111111111111
110011C01111100000000011C00000E1
11P00010111M001111110M0111100011
1111100000000011C000000000001111
11111111111111111111111111111111
