11111111111111111111111111111111
100000000000000000000000000000C1
11P00000000M00000000000000000E11
10000000000000000000000000000001
11111111111111111111111111111111
