1111111111111111
1000C00110000001
10aP00000000E001
1000000110000001
1111111111111111
